"Fancy Map Test"
-----------------------------
-----------------------------
-------------===========-----
-------------===========-----
-------------===-------------
-------------==========------
-------------==========------
-------------===-------------
-------------===-------------
-------------===-------------
-------------===-------------
-------------===-------------
-------------x==-------------
-----------------------------
-----------------------------