"Fancy Map Test"
-----------------------------
-----------------------------
-------------===========-----
-------------===========-----
-------------===-------------
-------------==========------
-------------=x========------
-------------===-------------
-------------===-------------
-------------===-------------
-------------===-------------
-------------===-------------
-------------===-------------
-----------------------------
-----------------------------